R 400 400

NO ./path_to_the_north_texture
SO ./path_to_the_south_texture
WE ./path_to_the_west_texture
EA ./path_to_the_east_texture
S ./path_to_the_sprite_texture

F 220,100,0
C 225,30,0

    11111111111
    10000000001
    1000000111111111111
    1100000000000000001
    1011100111000011111
    100W000000000011
11111000000000000001
11111111111111111111
