R 1920 1080

NO ./path_to_the_north_texture
SO ./path_to_the_south_texture
WE ./path_to_the_west_texture
EA ./path_to_the_east_texture
S ./path_to_the_sprite_texture

F 220,100,0
C 225,30,0

      1111111111111111111
      1000000110000000001
      10000000000000000011111
      10000001100000111011111
11111111000111011101010011
10000011000001110111100001
1111111111000000N100001111
        101101010111111
        111111111111111


