R 500 500

NO ./textures/bluestone.png

SO ./textures/eagle.png

WE ./textures/wall_3.png

EA ./textures/wall_2.png

S ./textures/barrel.png

F 0,0,0
C 255,0,0

    11111  111111
    10001  100201
  111000111100001
  111110010000001
11100000000000001
10200000000100001
10000000000000001
10200000000W00011
10000000000000001
10000011111100001
1000001    100001
1000001    100001
1100101    111001
1000001    100001
1011111    100001
1000001    100001
1100001    100011
1111111    111111
