R 1920 1080

NO ./path_to_the_north_texture

SO ./path_to_the_south_texture

WE ./path_to_the_west_texture

EA ./path_to_the_east_texture

S ./path_to_the_sprite_texture

F 220,100,0
C 225,30,0

    11111  111111
    10001  100001
  111000111100001
  111110010000001
11100000000000001
10000000000100001
10000000000000001
10000000000W00011
10000000000000001
10000011111100001
1000001    100001
1000001    100001
1100101    111001
1000001    100001
1011111    100001
1000001    100001
1100001    100011
1111111    111111
