R 500 500

NO ./textures/bluestone.png

SO ./textures/eagle.png

WE ./textures/wood.png

EA ./textures/wall_4.png

S ./textures/barrel.png

F 250,50,40
C 25,200,20

11111111111111111111111111111
10000000001100000000000000001
10110000011100000000000010001
10010000000000000000000010001
10110000011100000000000010001
10000000001100000111011110001
11110111111111011100000010001
11110111111111011121010010001
11000000110101011100000010001
10000000000000001100000010001
10000000000000001102010020001
11000000110101000000000000001
11110111110101000000202000001
10000000001100000100000010001
10000000000000002000000001001
10000000001000010002020001001
10000000001101000000W20000001
10000000000100000002020000001
11111111111111111111111111111
