R 848 9352156313554153136515313513513

NO ./textures/bluestone.png

SO ./textures/eagle.png

WE ./textures/wall_3.png

EA ./textures/wall_2.png

S ./textures/pillar.png

F 184,233,39
C 51,198,227

    11111  111111
    10001  100201
  111000111100001
  111110010000001
11100000000000001
12000000000010001
10000000000000001111111111111111111
10200000000000N00000000000000000001
10000000000000000000000000000000001
10000011111100001111000111111100001    11111111111111111111
1000001    100001  10001     100001    10000000000000000001
1000001    100001  1000111111100001    10000111111111110001
1100101    111001  1000000000000001    100001         10021
1000001    100001  11111111111000011111100001111111   11111
1011111    100001            1000000000000000000011
1000001    100001            1111111111111111111111
1100001    100001
1111111    111111
